XXXXOOOO
XXXXOXXX
XXXXOOOO
POOOOXXX
XXXXOXXX
XXXXOOOO
XXXXXXXX