XXXXOOOO
XOOOOXXX
XOXXXXXX
XOXXOOOO
XOXXOXXX
XOOOOXXX
XPXXOOOX