XPXXOOOO
XOXXOXXX
XOXXOOOO
OOOOOXXX
OXXXOXXX
OOOOOXXX
XXXXOOOO